1111-111-1111
----2---2----
0000-000-0000
0000-000-0000
0000-000-0000