2222222222222
1111111111111
0000000000000
0000000000000
0000000000000